######### #######
#       #   #   #
# # ### # # # # #
# # #   # # # # #
# # # ### # # # #
# # #       # # #
# # # ####### # #
# # # #   #   # #
# # # # # # ### #
#   #   # #   # #
# ####### ### # #
# #   #   #   # #
# # # # ### ### #
#   # # #   #   #
# ### # # # # ###
#     #   #     #
############### #

