##################### ###########
#                         #     #
# ### ##### ### ##### ### # ### #
#   # #     #   #     #   # #   #
### # # ##### ### ##### ### # # #
#   #   #   #     #     #   # # #
# # ##### # # ### # ##### # # # #
# # #   # # # #   # #   # # #   #
# # # # # # # # ### # # # # #####
#   # # # #   #       # # # #   #
##### # # ######### ### # # # # #
#   # # #     #   #     # # # # #
# # # # ##### # # ####### # # # #
# #   #   #     #   #   #   #   #
# ### ### # # ##### # # ### # ###
#   # #     # #   #   #   # #   #
### # # ##### # # # ### # # ### #
#   # #       # # # #   #       #
# # # # ####### # # # ######### #
# #   # #       # # #           #
# ##### # # ##### # #############
#     # # # #   # #       #     #
# ### # # # # # # ####### # ### #
#   # #   #   #         #       #
# # # ### ####### ##### ####### #
# # #   #       # #   #       # #
# # ### ### ### # # # ####### # #
# # #     # #     # #     #   # #
# # # # # # # # ### # ### # # # #
# # # # # #   # #   # #     # # #
# # # # # # ### # ### # # ### # #
#   #     #     #       #       #
# ###############################

