############################################### ###############
############################################### ###############
############################################### ###############
###     ###         ###             ###     ###             ###
### ### ### ### ### ### ### ####### ### ### ############### ###
### ### ### ### ### ### ### ####### ### ### ############### ###
### ### ### ### ### ### ### ####### ### ### ############### ###
### ###     ### ###     ### ###         ### ###     ###     ###
### ####### ### ########### ### ########### ### ### ### ### ###
### ####### ### ########### ### ########### ### ### ### ### ###
### ####### ### ########### ### ########### ### ### ### ### ###
###         ###     ###     ### ###         ### ### ### ### ###
################### ### ### ### ### ####### ### ### ### ### ###
################### ### ### ### ### ####### ### ### ### ### ###
################### ### ### ### ### ####### ### ### ### ### ###
###                     ### ### ###         ###         ### ###
### ####################### ### ########################### ###
### ####################### ### ########################### ###
### ####################### ### ########################### ###
### ###                     ###         ###     ###         ###
### ### ################### ########### ### ### ### ###########
### ### ################### ########### ### ### ### ###########
### ### ################### ########### ### ### ### ###########
###         ###         ###         ### ### ### ### ###     ###
########### ### ####### ########### ### ### ### ### ### ### ###
########### ### ####### ########### ### ### ### ### ### ### ###
########### ### ####### ########### ### ### ### ### ### ### ###
###             ###             ###     ###     ###     ### ###
### ############### ### ####### ############### ########### ###
### ############### ### ####### ############### ########### ###
### ############### ### ####### ############### ########### ###
### ###         ### ### ###     ###         ###         ### ###
### ### ####### ### ### ### ### ### ### ### ########### ### ###
### ### ####### ### ### ### ### ### ### ### ########### ### ###
### ### ####### ### ### ### ### ### ### ### ########### ### ###
### ###     ### ###     ### ### ### ### ###     ###     ### ###
### ####### ### ### ####### ### ### ### ####### ### ### ### ###
### ####### ### ### ####### ### ### ### ####### ### ### ### ###
### ####### ### ### ####### ### ### ### ####### ### ### ### ###
### ###     ###     ###     ### ### ###     ###     ### ### ###
### ### ############### ### ### ### ####### ####### ### ### ###
### ### ############### ### ### ### ####### ####### ### ### ###
### ### ############### ### ### ### ####### ####### ### ### ###
###     ###             ### ### ###     ###     ###     ### ###
########### ### ########### ### ####### ####### ########### ###
########### ### ########### ### ####### ####### ########### ###
########### ### ########### ### ####### ####### ########### ###
###         ###         ###         ### ###     ###         ###
### ################### ########### ### ### ### ### ### #######
### ################### ########### ### ### ### ### ### #######
### ################### ########### ### ### ### ### ### #######
### ###     ###     ### ###         ### ### ### ### ###     ###
### ### ### ### ### ### ### ########### ### ### ### ####### ###
### ### ### ### ### ### ### ########### ### ### ### ####### ###
### ### ### ### ### ### ### ########### ### ### ### ####### ###
###     ### ### ### ### ### ###         ###     ###         ###
### ####### ### ### ### ### ### ### ####################### ###
### ####### ### ### ### ### ### ### ####################### ###
### ####### ### ### ### ### ### ### ####################### ###
###             ###     ###     ###                         ###
############################################### ###############
############################################### ###############
############################################### ###############

