###################################### ################
# # # #  #  # #    #   #    # # #   #   #  # # #  #   #
# # #  #  # #  ## #   # ##  # #  #   #  ## #   #     ##
# #  # #  # ## #  ##  # # # #     # ## ##  # #    ### #
# ## #  # # #    #   #  #   ## #    #   ##    #### #  #
# #  ##   # # # #   #   #  ##   #  #  ##   ### #     ##
# #  #   #  #  #   # #   # # #   #     # ## #     ### #
#  #  ##       # ##  #   #   ##   # # ##        ##    #
## #  #  ###  #   ##  # #   ##     ##  # # # ### #  ###
#  ## ###    #   #  #     ## ##      # #  #  ###   #  #
#  #  #  #  #   #   #   ##     #    # ## # #      #   #
## ##  # # #   # #    ## # ##  # ## #  #    ##  ##  ###
#  #   #   ## #   #  #   #   #   # #   #   #  #       #
## ### #  #   ##   #  #  #    ##     # # #   # # # ####
#  #     #   #  ##  #     ##    #   ###  #   #  ##    #
##    # #   #     # # ##  #  #   ##   #   # #   # #  ##
# ##  # #  #  ###    #   ## ##     ## # ### ##  #  #  #
#   ###   ######  ##  #      #  #### ##    #  #   # ###
# # #  ##     #  #  #  #   #  #       #  # #   #  #   #
##  #  # ###    #      #  #   # #  #####  #    ##   ###
#   ##   ## ## #   #     #   ######   #   # #     ##  #
### #  ## #   ##  #    ######   #      # #   #  ##    #
#   ## #    # # ### # #        #  #  # #  ## # # # # ##
### #    # #    #  ##    ####   ##  #   #    ##    ## #
# # ##  #  ###    #  ###     #    ##   ##  ##    ##   #
#   #  #  #   ###     # ##    # # # ##    # # ###    ##
## #  #  #  #      # ##   ###  #  #     ##  #  #   #  #
#  # #  #  #   #  #    ##   #   #   # ##     #   ## # #
## # #  #   # #  #  #  ## #   # #   ## ## # ##  # # # #
#  ##  # #   #  # #  # #   #  #  # #     ## # # # #  ##
#  #  #   ###  #   #  # # # # #   #  #####    #   #   #
## # #   # #  #  #      #    #  #       # #    # ##  ##
#  # #       #    # # ###  # # #  ###  #   #      #   #
#  ## #  #  # ##   ##    # #  #  #   #   #  #   #   ###
## #   ##  #     #   ##  #  ## #   #  ## # # #   #    #
#  # #    #  # ##  #   #   #    #  # ## ##    #  #  ###
# ###    #   # ###  #   ##  #    #  #     ##  ##  #   #
#  #    # # ### #    #  # #    #  #  ## #   #     # ###
## #   #     #  # # # #    ## #    #     ##  ## #  #  #
#     #   ##  #  #  # #   ## ##     #  #   #   ##    ##
###  #  ##    #  #     #   #   #  #  #  ##  # ## # #  #
#   # ##    #  # ##   # #    #  ##    #   #  # #  ##  #
#  #    ## #  ##         ###  #   # #  #   ##    #  ###
# #   #   ##    ### # # ##   #     ##   # # #   #  ## #
##  # #     ### #    ###  # #        ## ##  #  #  #   #
#    ## # #      ## #      #       #   #      #       #
# ## #  ##   # ####  ## # #   ## ##  ## #    #  ###   #
#### #  #  ####  ###    ##  #   ### #       #   ##    #
#    # ####   #    #  #  #  #     ##  # ## #  #   # # #
#  ####        # #   #  # #  # # #   ##   #  ##########
###  #  #  #   ###  #  #   # # ##  #   # #   #        #
#      #  #  # #   #  #  #    #   ###   #  # # #  #####
#  #  #   # #  #  #  #   ## ##  #  #   #  ##    #     #
# #  #   #   #  ##  #      #     # #  #    # ##  #    #
###  ## #  ##  ##  #  #  ##   ##  ## #  #  # ##   #  ##
#  ###  ###     #  #  # #   # #     #  ## ##   ##  #  #
##     #     #    #    #  #  ## ####    #  #     # #  #
#    # #  #  # # #   #     #  #       #  # # # # #  # #
## ####################################################
