##################################################### ###########################################################################
#   #                                       #       #   #         #   #                           #           #     #           #
# # # # ################################### # ### # ### # # ##### # # # ######################### # ####### # # # # # ### ##### #
# #   #     #             #   #   #     #   # #   #       # #   #   #   #   #               #       #   #   # # # # # #   #   # #
# # ####### # # ######### # # # # # ### # ### # ########### # # ### # ### # # ##### ####### # ####### # # ### # # # # # ### # # #
# # #     # # # #     #     # # #   #   # #   # #   #   #   # #   # #   # #   #   # #       # #       # #   # # #   #   #   #   #
# # # ### # # # # # # # # # # # # ### # # # # # # # # # # # # ### # ### # ##### # # # # ##### # ####### ### # # # ##### # # # ###
# # # #   # #   # # # # # # # # # #   #   # #   # #   #   #       # #     #     # #   # #       #       #   # # # #   # # # #   #
# # # # # # ##### # # # # # # # # # ####### ##### ### # ######### # # ##### ##### ##### # ####### ##### # ### # # # # # # # ### #
#   # # # #         #     #   #   # #     # #       # #     #   # #   #   # #   #       # #   #       #       # # # #     # #   #
##### # # ############# ######### # # ### # # ### # # ##### # # # # ### # # # # ######### # # # ##### ### ### # # # ####### # # #
#   #   #             # #         # #     #   #   # #     # # # # # #   #     # #       #   #   #     #   #   #   # #         # #
# # ####### ### ##### # # ######### ##### ##### ### ##### # # # # # # ######### # ##### # ####### ##### ### ##### # # ### # ### #
# # #     # #   #       #           #     #   #     #   # # #     # # #       # # #     #   #   #     #     #   # # #     #     #
# # # ### # # ### ########### ####### ##### # ####### # # # ####### # # ##### # # # ####### # # # ### ##### # # # # #############
# # #   # #   #   #         #     #         # #   #   # #         #   #         # # #     #   # #         #   # # #   #     #   #
# # ### # ##### ### # ##### ### # # ######### # # # ### ####### # # ######### ### # # ### ##### ######### ##### # ### # ### # # #
#       #   #   #   # #   #   # # #         # # # #     #       # # #       # #   # #     #   #     #   # #       #     #   # # #
########### # # # ### # # ### # # ##### ### # # # ### ### ### ### # # ##### # # ### ### ### # ##### # # # # ### ### ##### # # # #
#   #     # # #   #   # #     #   #   # #   #   #     #     #       #     # # # #   #   #   #         #   #     #   #     #   # #
# # # ### # # ### # # # ##### ### # # # # ### ######### ### ############# # # # # ### ### ############### ####### # # ######### #
# # #   # # #   # # # # #   #   # # #   # #   #         #       #         # # #   #   #   #               #   #   # # #   #     #
# # # # # # ### # # # # # # ### # # ### # # ### # ####### ##### # ####### # # # ### ### ### ############### # # # # # # # # #####
# #   # # #   # # # #     #     #   #   # # #   # #     # #     # #     #   #   #     #   # #     #         #   #   #   # # #   #
# # ### # # # # # # ################# ### # # # # # # # # # # ### # ### ######### # # ### # # ### # # ##### # ##### ##### # # # #
# # #     # # #   #   #             #     #   #   # # # #   #     #   #         # # # #     # #     #     # # #   #     # # # # #
# # # ##### # ### ### # ####### ### ############# # # # ######### ### ######### # # # # ##### # ######### # # # # ##### # # # # #
# #     #   #     #   # #       #       #       # # # #         #   #     #     #   #   #   #   #       # # #   #     # # #   # #
# ### # # ######### ### # ####### # ### # ##### # # # ### ### # ### ##### # ############# # # ### ### # # # # ##### # # # ##### #
#     # #             # # #     # #   # # #   # # # #   #     #   #   #     #     #       # #   #   # # #   #     # # # #     # #
####### ##### ##### # # # # ### # ### # # # # # # # ### ####### # # # # ##### ### # ##### # ### ### # # ######### # # # ##### # #
#     #       #   # # # #   #   #   #   # # # # # #             # # # #     #   #       #   #       # #         # #     #     # #
# ### ######### # # # # ##### ##### ##### # # # # ##### ######### # # ##### # # ####### ##### ####### ######### # ####### ### # #
# #     #       # # # #       #             # # #       #     #   #   #   #   #       #   #   #     # #   #     # #   #       # #
# # ### # ####### # # ######### ############# # ##### ### ### # ####### # ########### ### # ### ### # # # # ##### # # # # ##### #
#     #   #   #   # # #                 #   # #     #   # #   # #   #   #           #     #     #   #   # # #   #   # # #       #
##### ##### # # ### # # ############### # # # ##### ### # # ### # # # # # ######### ### ######### ##### # # # # ##### # #########
#   # #     # #       # #         #   # # # #             #     # # # # #         #     #   #   # #     #   # #       #   #     #
# # # # # ### ##### ### # ####### # # # # # ##################### # # # ### ##### ####### # # # # # ##### ### ######### # # ### #
# # #   #     #     #     #   #     # # # #         #             #   #     #   #   #     #   #     #   #     #       # # # #   #
# # ### ####### ##### ##### # # ##### # # ######### # ##### ##### ########### # # # # ### ########### # ##### # # ### # # # # ###
# #   #       #       #     #   #     # #           #     #     #       #     # # # #   # #   #       #       # # #   #   #     #
# ### ### ### # ####### # ####### ### # # ############### ##### ####### # ##### # # ### # # # # ############### # # # ######### #
#     #   #   # #       #   #   #     # # #   #           #     #         #   # # #   # #   # # #             #   # #         # #
# ##### ### # # # ######### # # ####### # # # # ########### ##### ##### ### # # # ### # ##### # # # ### ### # ##### ######### # #
# #     #   #   #     #   #   # #       #   # #           #     # #   #     # # # #   #       # # #   #     #       #         # #
# # # ### ########### # # ### # # ##### # ### ####### ### # ### # # # ####### # # # ### ##### # # ### ########### ### # ##### # #
# # #               #   #   #   #     # # #   #     #     # #   #   #         #     #   #   #     #             # #   # #   # # #
# # ##### ######### ####### ######### # # # # # ### ####### # ################### ### ### # ####### ########### # # # # # # # # #
# #   #   #       # #     #         #   #   # #   #         #               #   # #   #   # #     #           # #   # #   # #   #
# # # # ### # ### # # # # ##### ### ### ##### ### ##### ### ####### ####### # # # # ### ### # ### ########### # ##### ##### #####
# # #   #   # #   # # # # #   #   #   #     #   #     #     #     #   #   # # #   # #       #   #   #         # #   # #   #     #
# # # ### ### # # # # # # # # ### # # ##### ### # ### ### ### # # ### # # # # ### # # ######### # # # ####### # # # # # # ### # #
# #   #   #   # # #   #   # #     # # #   #     #   #   # #   # #   #   # #   #   # # #   #     # #           #   # # # #   # # #
# ##### ### ### # ######### ####### # # # ### ##### ### # # # # ### ##### ##### ### # # # # # ### ################# # # # # # # #
#     #   # #   #               #   # # #   # #         #   # # #     #       #   #   # # # # #                     #   # #   # #
##### ### # # # ### ########### # ### # ### # # ############# # # ### # ##### ### ##### # # # # ############### ### ##### ### # #
#       #     # #   #         # # #   #   #     #               # #   #     # #       #   # #   #   #   #     #   # #     #   # #
# ##### ####### # ### # ### # # # # ##### ####### ############### # # ##### # # # ### ### # ##### # # # # ### ### # # ##### ### #
# #   # #       # #   #   # # # # #     # #   #   #     #         # # #   #     #   #   # #       # # # #   #     #   #   # #   #
# # # # # # ### # # # ### # # # # ##### # # # # # # # # # ##### ### # # # ### ##### ### # ### ### # # # ### # ######### # # # ###
# # # #   #     # # #   #   # # # #     #   # # #   # #   #   #   #   # #     #   #     #   # #   # # #   # #   #     # # # #   #
# # # # ######### # ### ### # # # # # ##### # # ### # ##### # ### ##### # ##### # ######### # # ### # # # # ### # # # # # # ### #
# # # # #       # # #       #     # # #   #   # #   #   #   #           #   #   #   #       #   #   # # #       # # #   #       #
# # # # # # ### # # # ############# # # # ##### # ##### # # ##### ######### # ### # # ##### # ### ### # ### ##### # # ###########
# # # #   # #   # #   #     #       # # #     # #   #     # #   # #         #     #   #     # #   #   #   # #     # # #     #   #
# # # ### # # ### ##### ### # ### ### # ##### # ### # ##### # # # # ############### ### # ### # # # ##### # # ##### # # ### # # #
# # #   #     #         #   #   #     #   #   #       #     # #   #     #         #   # # #     # # #     #         # #   # # # #
# # ### ####### # ####### ##### ### ##### # ########### ##### ######### # # ### # ### # # # ##### # # # ############# ### # # # #
# #   #       # #     #   #         #   # #     #   #   #   #         #   # #   # #   # # # #   #   # #     #   #         #   # #
# ### ####### # ##### # ### ######### # # # ### # # # # # # ######### ### # # ### # # # # # # # ##### ##### # # # ####### ### # #
#   #     #   #     # #   #           # #   #   # # # # # # #     #     #     #     # # # # # # #     #     # # # #       #   # #
# # ##### # # ### # # ### ########### # ##### # # # # # # # # ### # ### ####### # ### # # # # # # ##### ##### # # # # ##### ### #
# # #   #   #     # #         #     # #       # # # #   #     #   #   #   #   # # #   # #   # #   #   #     # # #   #     #     #
# # # # ########### # ####### # ### # ##### ### # # ########### ##### # # # # # # # # # ##### ##### # ##### # # ######### #######
# # # # #     #       #     # #   # # #     #     # #           #   # # #   # #     # # #   # #     # #     # #         #       #
# # # # # ### # ####### ### # # # # # # ##### ##### # ########### # # # # ### ####### # # # # # ##### # ##### # ####### ####### #
# # #     #     #     #   #   # # #   # #         # #   #   #     #     #     #   #     # #   #       # #       #   #   #       #
# # ####### # ### ### ### # ### # # ### # ####### # ### # # # # ############### # # ##### ######### ### # ####### # # ### ##### #
#     #     # #   #       # #     #       #         #     # # # #               #         #         #   # #       # # #   #   # #
##### # ##### # # # ##### # # # ########### # ####### # # # # # # ######################### ### ##### ### # ####### # # ### # # #
#   # # #     # # # #   # # # # #     #     # #       # # # # # # #             #     #   # #   #   #   #   #     #   # #   # # #
# # # # # ### # # # # # # # # # # ### # # ### # ####### # # # # # # ### ####### # ### # # # # ### # ### ##### ### # ### # ### # #
# # # # #   #     # # #   #     # #     # #     #     # #   # # # #   # #       # #     #   # #   #   # #     #   # #   #     # #
# # # # ### ####### # ########### # ##### # ##### # # # ##### # # ### # # ##### # # # ####### # # ### # # ##### ### # ####### # #
#     # #     #     # #             #   # # #   # # # # #       #     #   #   #     #       #   #     #   #     #   #   #     # #
####### # ### # # ### # ######### ### # # # # # # # # # # ### ############# # ############# ############# # # ### ##### # ##### #
#     #   #   # #   #   #   #     #   # # # # # # #   #     #     #         #             #       #     #   #   # #     # #     #
# ### ##### ### ### ##### # # ##### # # # # # # # # ####### ##### # ######### ########### ####### # ### ####### # # ##### # ### #
# #   #   #   # #   #     # #       #   #   #     #         #   #       #   # #             #     #         #   # # #     #     #
# # # # # ### # # ### # ### # ##### ####### ##### ####### ### # ### ### # # # # # ######### # ### ####### # # ### # # ####### ###
#   #   #     # #   # # #     #   # #     #     # #     #     #   #   # # # # # # #   #   #     #         #     # # #       #   #
######### ### # # # # # # ##### # # # ### ### # # # ### ######### ### # # # # # # # # # # ##### ############# # # # ####### ### #
#       #   #     #   # #       #   # #     # # # #   #         #     # # #   # #   # # #   #         #       # #   #         # #
# ##### ### ### ####### ############# # # # # # # ### ######### ####### # ### # ##### # ### # ##### # # ####### ##### ####### # #
# #       # #   #   #         #     # # # # # #   #   #   #   #     #   #     # #     #   # # #     #   #     # #     #       # #
# # ##### # # ### # # # ### # # # # # # # # # ##### ### # # # ##### # # ####### # ### ### # # # # ### ### ### # # ##### ####### #
#   #     #   #   # # # #   #   # # # # # # #     # #   # # # #     # # #   #   #     #   #   # #   # #   #     # #   #     #   #
##### ### # ### ### # # # ####### # # # # # ##### # # # # # # # ##### # # # # # ### ### # ### # ### # # # # ##### # # ### # # ###
#     #   #   #     #   # #     # # # # # #         # # # #   #     #     # # #     #   #     #     # # # # #   #   #     # #   #
# ##### ##### # ####### # # ### # # # # # ########### # # ### # ### ### ### # ### ### ############# # # # # # # ########### ### #
# #   #     # # #     #         #     # #   #       #   #   # #   #   #     #     #   #       #   # #   #   # # #     #   # #   #
# # # # ### # # # ### ############# ### ### # ##### ### # # # ### ### ############# ### ##### # # # ##### ### # # # # # # # # # #
#   # # #   #   # #   #           #   #   #     #       # # #   #     #       #     #         # # #     #   #     # # # # # # # #
### # # # ####### # # # ##### ### ### ### ##### # ####### # ### ####### ##### # ##### ######### # ### # ### ####### # # # # # # #
#   # #   #     #   # #       #     #   #     #   #       #   # #   #   #   # #     #     #   #   #   #   #         #   #   #   #
# ### # ### # # ##### ##### ### ### ### # ### ### # ##### ### # # # # ### # # ##### ##### # # # ### ### # #######################
# #   # #   # #           #   #     #   #     #   #     # #   # # # # #   #         #     # # # #   #   #   #     #       #     #
# # ### # ### ########### ### ####### ##### ### ####### # # ### # # # # ############# # ### # # # ### ### # # # # # ##### # ### #
# # #   #       #   #     #       #   #   #           # #   #       #       #       # #     #   # #     # #   # # #     # # #   #
# # # ######### # # # ##### ##### # # # # ########### # ##### ######### ### # ##### # ####### ### # ### # ### # # ##### # # # # #
# #   #     #     # #             # #   #           #   #     #       # #   # #     #   #   # #     #     #   #   #     # #   # #
# ### # ### # # ### ########### ### ########### ### ### # # ### ##### # # ### # ### ### # # # # ##### ##### ##### # ##### ##### #
#   # # #   # # #               #       #     # #   #   # # #   #   #   # #   #   # #     #   #   #   #   # #   # # #           #
# # # # # ### # # ############### ##### # ### # # # # ### # # ### # ### # # # ### # # ########### # ### # # # # # # # ####### ###
# #   # #   # # # #           #   #     # #   #   # #     #   #   # #   #   #     #   #   #   #   #   # # #   #   #   #     #   #
# # ### ### # # # # # ### ### # ### ### # # ##### # ##### ##### # # # ##### ### ##### # # # # # ##### # # ### ####### # ### ### #
# # #       # # #   # #   #   #     #   # #     # #     # #   # #   # #   #   #       # # # #   #     # #   #   #     # #     # #
# # # # ### # # ##### # ### ##### ### ### # ### # ### # # # # # ##### # # ### ### ##### # # ##### ### # ### ### # # ### # ### # #
# #   # #   # #     #   #       # #     # # #   #   # #   # # #     #   #   # #   #   # #   #   #   # # #     # # #       #   # #
# # ### # ### ##### ##### # ### # # ### # # # # ### # ### # # ##### ### ### # # ### # # ##### # ### # # # # # # # ######### ### #
#   #   # #   #   # #     #     # #   # #     #       #   #           #       # #   #   #   # #   # # # # # # #   #         #   #
# ### # # # ### # # # ####### ### ### # ####### ####### ########### # ######### # ####### # # # # # # # # # # ##### ##### ### ###
#     # # # #   # #     #     #       #     #   #     # #     #   # #         #           # #   #     #     # #     #   # #     #
### ### # # # ### ##### # ##### ########### # ### ### # # ### # # # ### ##### ### ######### ################# # ##### # # # ### #
#   #     #   #       # # #   #     #       #     #   #   #   # # #   #   #     # #   #   #       #   #       # #   # # # #     #
# ### ######### # ### # # # # ##### # ############# # ##### ### # ### ### # ### # # # # # ##### # # # # # ##### # # # # # # ### #
#               #     #     #       #               #           #   #     #         #   #       #   #   #         #   #   #     #
################################################################### #############################################################

