# #############################################################
#     #   #                   #           #   #       #       #
##### # # # ################# # ######### # # # ##### # ##### #
#   # # # #     #             # #   #   # # # #     # # #     #
# # # # # ##### # ############# # # # # # # # ##### # # # #####
# # #   # #     # #       #   # # # # # #   # #     #   # #   #
# # ##### # ##### # ##### # # # # # # # ##### # ######### # # #
# #     # # #   # # #     # # #   # # #     # #     #   # # # #
# ##### # # # # # # # ##### # ##### # ##### # ##### # # # # # #
# #   # # # # # #   # #     # #   # # #     #       # # #   # #
# # # # # # # # ##### # ##### # # # # # ############# # ##### #
# # # # # #   # #     #     # # # # # #     #   #     # #   # #
# # # # # ##### # ######### # # # # # ##### # # # ##### # # # #
#   # # # #     #           #   #   #     # # # # #   # # # # #
##### # # # ############################# # # # # # # # # # # #
#     #   #             #                 #   #   # # #   # # #
# ##################### # ######################### # ##### # #
#         #   #   #     #                     #   # #     # # #
######### # # # # # ######################### # # # ##### # # #
#         # # # # # #   #   #           #   # # # # #     #   #
# ######### # # # # # # # # # ######### # # # # # # # #########
# #   #   # # # #   # # # # # #   #     # # #   # # # #       #
# # # # # # # # ##### # # # # # # # ##### # ##### # # # ##### #
# # # # # # # #     # #   # # # # # #     # #     # # # #   # #
# # # # # # # ##### # ##### # # # # # ##### # ##### # # # # # #
#   # # # # # #     #     # # # #   # #     #       #   # # # #
##### # # # # # ######### # # # ##### # ################# # # #
#     # # # # # #         # # #       #     #       #     # # #
# ##### # # # # # ######### # ############# # ##### # ##### # #
#     # #   # # # #       # #     #   #   # # #     # #     # #
##### # ##### # # # ##### # ##### # # # # # # # ##### # ##### #
#   # #     # #   #     # #     # # # # # # # #     # # #   # #
# # # ##### # ######### # ##### # # # # # # # ##### # # # # # #
# # # #     # #         # #     # # #   # # # #     # # # # # #
# # # # ##### # ######### # ##### # ##### # # # ##### # # # # #
# # # # #     # #         #     # #     # #   #     # #   # # #
# # # # # ##### # ############# # ##### # ######### # ##### # #
# # # # #     # #               #       #         # # #   # # #
# # # # ##### # ################################# # # # # # # #
# #   # #   # # #   #   #                         #   # # #   #
# ##### # # # # # # # # # ############################# # #####
# #     # # # # # # # # # #   #               #         #     #
# # ##### # # # # # # # # # # # ############# # ############# #
# #     # #   #   #   # # # # #     #         #             # #
# ##### # ############# # # # ##### # ##################### # #
# #     #     #   #     #   #       #     #                 # #
# # ######### # # # ##################### # ################# #
# # #   #     # # #     #   #           # # #   #   #       # #
# # # # # ##### # ##### # # # ######### # # # # # # # ##### # #
# # # # #       #     # # # # #   #     #   # # # # # #   # # #
# # # # ############# # # # # # # # ######### # # # # # # # # #
# #   #     #   #   # # # #   # # #     #     #   #   # # # # #
# ######### # # # # # # # ##### # ##### # ############# # # # #
#     #     # # # # #   #       #     # # #             # # # #
##### # ##### # # # ################# # # # ############# # # #
#     #     # # # #                   #   #     #         #   #
# ######### # # # ############################# # #############
# #       # # # #     #   #           #         #     #   #   #
# # ##### # # # ##### # # # ######### # ############# # # #   #
# # #     #   # #     # # # #         #         #     # # #   #
# # # ######### # ##### # # # ################# # ##### # #   #
#   #           #       #   #                   #       #     #
############################################################# #
