###############################
###############################
###############################
###
### ###########################
### ###########################
### ###########################
### ###     ###         ###
### ### ### ### ####### ### ###
### ### ### ### ####### ### ###
### ### ### ### ####### ### ###
### ### ###     ###     ### ###
### ### ### ####### ### ### ###
### ### ### ####### ### ### ###
### ### ### ####### ### ### ###
### ### ### ###     ### ### ###
### ### ### ### ### ### ### ###
### ### ### ### ### ### ### ###
### ### ### ### ### ### ### ###
### ### ###     ###     ### ###
### ### ################### ###
### ### ################### ###
### ### ################### ###
###     ###     ###     ### ###
########### ### ### ### ### ###
########### ### ### ### ### ###
########### ### ### ### ### ###
###         ### ### ### ### ###
### ####### ### ### ### ### ###
### ####### ### ### ### ### ###
### ####### ### ### ### ### ###

